31,31,31,31,31,31,31,31,31,31,255,255,255,255,255,255,255,255,255,255,255,255,255,255,255,255,255,255,255,255,255,255,255,255,255,255,255,255,255,255,255,255,255,255,255,255,255,255,255,255,255,255,255,255,255,255,255,255,255,255,255,255,255,255,255,255,255,255,255,255,255,255,255,255,255,255,255,255,255,255,255,255,255,255,255,255,255,255,255,255,255,255,255,255,255,255,255,255,255,255,255,255,255,255,255,255,255,255,255,255,255,255,255,255,255,255,255,255,255,255,255,255,255,255,255,255,255,255,255,255,255,255,255,255,255,255,255,255,255,255,255,255,255,255,255,255,255,255,255,255,255,255,255,255,48,49,50,51,52,53,255,255,255,255,255,255,255,255,255,255,255,255,255,255,255,255,255,255,255,255,255,255,255,255,255,255,255,255,255,255,255,255,255,255,255,255,48,49,50,51,50,51,50,51,50,51,52,53,255,255,255,255,255,255,255,255,255,255,255,255,255,255,255,255,255,255,48,49,52,53,255,255,255,255,255,255,255,255,255,255,255,255,255,255,255,255,255,255,255,255,255,255,255,255,255,255,255,255,255,255,255,255,255,255,255,255,255,255,255,255,31,31,31,31,31,31,31,31,31,31,31,31,31,31,31,31
31,31,31,31,31,31,31,31,31,31,255,255,255,255,255,255,255,255,255,255,255,255,255,255,255,255,255,255,255,255,255,255,255,255,255,255,255,255,255,255,255,255,255,255,255,255,255,255,255,255,255,255,255,255,255,255,255,255,255,255,255,255,255,255,255,255,255,255,255,255,255,255,255,255,255,255,255,255,255,255,255,255,255,255,255,255,255,255,255,255,255,255,255,255,255,255,255,255,255,255,255,255,255,255,255,255,255,255,255,255,255,255,255,255,255,255,255,255,255,255,255,255,255,255,255,255,255,255,255,255,255,255,255,255,255,255,255,255,255,255,255,255,255,255,255,255,255,255,255,255,255,255,255,255,64,65,66,67,68,69,255,255,255,255,255,255,255,255,255,255,255,255,255,255,255,255,255,255,255,255,255,255,255,255,255,255,255,255,255,255,255,255,255,255,255,255,64,65,66,67,66,67,66,67,66,67,68,69,255,255,255,255,255,255,255,255,255,255,255,255,255,255,255,255,255,255,64,65,68,69,255,255,255,255,255,255,255,255,255,255,255,255,255,255,255,255,255,255,255,255,255,255,255,255,255,255,255,255,255,255,255,255,255,255,255,255,255,255,255,255,31,31,31,31,31,31,31,31,31,31,31,31,31,31,31,31
31,31,31,31,31,31,31,31,31,31,255,255,255,255,255,255,255,255,255,255,255,255,255,255,255,255,255,255,255,255,255,255,255,255,255,255,255,255,255,255,255,255,255,255,255,255,255,255,255,255,255,255,255,255,255,255,255,255,255,255,255,255,255,255,255,255,255,255,255,255,255,255,255,255,255,255,255,255,255,255,255,255,255,255,255,255,255,255,255,255,255,255,255,255,255,255,255,255,255,255,255,255,255,255,255,255,255,255,255,255,255,255,255,255,255,255,255,255,255,255,255,255,255,255,255,255,255,255,255,255,255,255,255,255,255,255,255,255,255,255,255,255,255,255,255,255,255,255,255,255,255,255,255,255,48,49,50,51,52,53,255,255,255,255,255,255,255,255,255,255,255,255,255,255,255,255,255,255,255,255,255,255,255,255,255,255,255,255,255,255,255,255,255,255,255,255,48,49,50,51,50,51,50,51,50,51,52,53,255,255,255,255,255,255,255,255,255,255,255,255,255,255,255,255,255,255,48,49,52,53,255,255,255,255,255,255,255,255,255,255,255,255,255,255,255,255,255,255,255,255,255,255,255,255,255,255,255,255,255,255,255,255,255,255,255,255,255,255,255,255,31,31,31,31,31,31,31,31,31,31,31,31,31,31,31,31
31,31,31,31,31,31,31,31,31,31,255,255,255,255,255,255,255,255,255,255,255,255,255,255,255,255,255,255,255,255,255,255,255,255,255,255,255,255,255,255,255,255,255,255,255,255,255,255,255,255,255,255,255,255,255,255,255,255,255,255,255,255,255,255,255,255,255,255,255,255,255,255,255,255,255,255,255,255,255,255,255,255,255,255,255,255,255,255,255,255,255,255,255,255,255,255,255,255,255,255,255,255,255,255,255,255,255,255,255,255,255,255,255,255,255,255,255,255,255,255,255,255,255,255,255,255,255,255,255,255,255,255,255,255,255,255,255,255,255,255,255,255,255,255,255,255,255,255,255,255,255,255,255,255,64,65,66,67,68,69,255,255,255,255,255,255,255,255,255,255,255,255,255,255,255,255,255,255,255,255,255,255,255,255,255,255,255,255,255,255,255,255,255,255,255,255,64,65,66,67,66,67,66,67,66,67,68,69,255,255,255,255,255,255,255,255,255,255,255,255,255,255,255,255,255,255,64,65,68,69,255,255,255,255,255,255,255,255,255,255,255,255,255,255,255,255,255,255,255,255,255,255,255,255,255,255,255,255,255,255,255,255,255,255,255,255,255,255,255,255,31,31,31,31,31,31,31,31,31,31,31,31,31,31,31,31
31,31,31,31,31,31,31,31,31,31,255,255,255,255,255,255,255,255,255,255,255,255,255,255,255,255,255,255,255,255,255,255,255,255,255,255,255,255,255,255,255,255,255,255,255,255,255,255,255,255,255,255,255,255,255,255,255,255,255,255,255,255,255,255,255,255,255,255,255,255,255,255,255,255,255,255,255,255,255,255,255,255,255,255,255,255,255,255,255,255,255,255,255,255,255,255,255,255,255,255,255,255,255,255,255,255,255,255,255,255,255,255,255,255,255,255,255,255,255,255,255,255,255,255,255,255,255,255,255,255,255,255,255,255,255,255,255,255,255,255,255,255,255,255,255,255,255,255,255,255,255,255,255,255,48,49,50,51,52,53,255,255,255,255,255,255,255,255,255,255,255,255,255,255,255,255,255,255,255,255,255,255,255,255,255,255,255,255,255,255,255,255,255,255,255,255,48,49,50,51,50,51,50,51,50,51,52,53,255,255,255,255,255,255,255,255,255,255,255,255,255,255,255,255,255,255,48,49,52,53,255,255,255,255,255,255,255,255,255,255,255,255,255,255,255,255,255,255,255,255,255,255,255,255,255,255,255,255,255,255,255,255,255,255,255,255,255,255,255,255,31,31,31,31,31,31,31,31,31,31,31,31,31,31,31,31
31,31,31,31,31,31,31,31,31,31,255,255,255,255,255,255,255,255,255,255,255,255,255,255,255,255,255,255,255,255,255,255,255,255,255,255,255,255,255,255,255,255,255,255,255,255,255,255,255,255,255,255,255,255,255,255,255,255,255,255,255,255,255,255,255,255,255,255,255,255,255,255,255,255,255,255,255,255,255,255,255,255,255,255,255,255,255,255,255,255,255,255,255,255,255,255,255,255,255,255,255,255,255,255,255,255,255,255,255,255,255,255,255,255,255,255,255,255,255,255,255,255,255,255,255,255,255,255,255,255,255,255,255,255,255,255,255,255,255,255,255,255,255,255,255,255,255,255,255,255,255,255,255,255,64,65,66,67,68,69,255,255,255,255,255,255,255,255,255,255,255,255,255,255,255,255,255,255,255,255,255,255,255,255,255,255,255,255,255,255,255,255,255,255,13,255,64,65,66,67,66,67,66,67,66,67,68,69,255,255,255,255,255,255,255,255,255,255,255,255,255,255,255,255,255,255,64,65,68,69,255,255,255,255,255,255,255,255,255,255,255,255,255,255,255,255,255,255,255,255,255,255,255,255,255,255,255,255,255,255,255,255,255,255,255,255,255,255,255,255,31,31,31,31,31,31,31,31,31,31,31,31,31,31,31,31
18,19,18,19,18,19,18,19,20,21,255,255,255,255,255,255,255,255,255,255,255,255,255,255,255,255,255,255,255,255,255,255,255,255,255,255,255,255,255,255,255,255,255,255,255,255,255,255,255,255,255,255,255,255,255,255,255,255,255,255,255,255,255,255,255,255,255,255,255,255,255,255,255,255,255,255,255,255,255,255,255,255,255,255,255,255,255,255,255,255,255,255,255,255,255,255,255,255,255,255,255,255,255,255,255,255,255,255,255,255,255,255,255,255,255,255,255,255,255,255,255,255,255,255,255,255,255,255,255,255,255,255,255,255,255,255,255,255,255,255,255,255,255,255,255,255,255,255,255,255,255,255,255,255,48,49,50,51,52,53,255,255,255,255,255,255,255,255,255,255,255,255,255,255,255,255,255,255,255,255,255,255,255,255,255,255,255,255,255,255,255,255,255,255,255,255,48,49,50,51,50,51,50,51,50,51,52,53,255,255,255,255,255,255,255,255,255,255,255,255,255,255,255,255,255,255,48,49,52,53,255,255,255,255,255,255,255,255,255,255,255,255,255,255,255,255,255,255,255,255,255,255,255,255,255,255,255,255,255,255,255,255,255,255,255,255,255,255,255,255,31,31,31,31,31,31,31,31,31,31,31,31,31,31,31,31
34,35,34,35,34,35,34,35,36,37,255,255,255,255,255,255,255,255,255,255,255,255,255,255,255,255,255,255,255,255,255,255,255,255,255,255,255,255,255,255,255,255,255,255,255,255,255,255,255,255,255,255,255,255,255,255,255,255,255,255,255,255,255,255,255,255,255,255,255,255,255,255,255,255,255,255,255,255,255,255,255,255,255,255,255,255,255,255,255,255,255,255,255,255,255,255,255,255,255,255,255,255,255,255,255,255,255,255,255,255,255,255,255,255,255,255,255,255,255,255,255,255,255,255,255,255,255,255,255,255,255,255,255,255,255,255,255,255,255,255,255,255,255,255,255,255,255,255,255,255,255,255,255,255,64,65,66,67,68,69,255,255,255,255,255,255,255,255,255,255,255,255,255,255,255,255,255,255,255,255,255,255,255,255,255,255,255,255,255,255,255,255,255,255,255,255,64,65,66,67,66,67,66,67,66,67,68,69,255,255,255,255,255,255,255,255,255,255,255,255,255,255,255,255,255,255,64,65,68,69,255,255,255,255,255,255,255,255,255,255,255,255,255,255,255,255,255,255,255,255,255,255,255,255,255,255,255,255,255,255,255,255,255,255,255,255,255,255,255,255,31,31,31,31,31,31,31,31,31,31,31,31,31,31,31,31
50,51,50,51,50,51,50,51,52,53,255,255,255,255,255,255,255,255,255,255,255,255,255,255,255,255,255,255,13,255,255,255,255,255,255,255,255,255,255,255,255,255,255,255,255,255,255,255,255,255,255,255,255,255,255,255,255,255,255,255,255,255,255,255,255,255,255,255,255,255,255,255,255,255,255,255,255,255,255,255,255,255,255,255,255,255,255,255,255,255,255,255,255,255,255,255,255,255,255,255,255,255,255,255,255,255,255,255,255,255,255,255,255,255,255,255,255,255,255,255,255,255,255,255,255,255,255,255,255,255,255,255,255,255,255,255,255,255,255,255,255,255,255,255,255,255,255,255,255,255,255,255,255,255,48,49,50,51,52,53,255,255,255,255,255,255,255,255,255,255,255,255,255,255,255,255,255,255,255,255,255,255,255,255,255,255,255,255,255,255,255,255,255,255,255,255,48,49,50,51,50,51,50,51,50,51,52,53,255,255,255,255,255,255,255,255,255,255,255,255,255,255,255,255,255,255,48,49,52,53,255,255,255,255,255,255,255,255,255,255,255,255,255,255,255,255,255,255,255,255,255,255,255,255,255,255,255,255,255,255,255,255,255,255,255,255,255,255,255,255,31,31,31,31,31,31,31,31,31,31,31,31,31,31,31,31
66,67,66,67,66,67,66,67,68,69,255,255,255,255,255,255,255,255,255,255,255,255,255,255,255,255,255,255,255,255,255,255,255,255,255,255,255,255,255,255,255,255,255,255,255,255,255,255,255,255,255,255,255,255,255,255,255,255,255,255,255,255,255,255,255,255,255,255,255,255,255,255,255,255,255,255,255,255,255,255,255,255,255,255,255,255,255,255,255,255,255,255,255,255,255,255,255,255,255,255,255,255,255,255,255,255,255,255,255,255,255,255,255,255,255,255,255,255,255,255,255,255,255,255,255,255,255,255,255,255,255,255,255,255,255,255,255,255,255,255,255,255,255,255,255,255,255,255,255,255,255,255,255,255,64,65,66,67,68,69,255,255,255,255,255,255,255,255,255,255,255,255,255,255,255,255,255,255,255,255,255,255,255,255,255,255,255,255,255,255,255,255,255,255,255,255,64,65,66,67,66,67,66,67,66,67,68,69,255,255,255,255,255,255,255,255,255,255,255,255,255,255,255,255,255,255,64,65,68,69,255,255,255,255,255,255,255,255,255,255,255,255,255,255,255,255,255,255,255,255,255,255,255,255,255,255,255,255,255,255,255,255,255,255,255,255,255,255,255,255,31,31,31,31,31,31,31,31,31,31,31,31,31,31,31,31
50,51,50,51,50,51,50,51,52,53,255,255,255,255,255,255,255,255,255,255,255,255,255,255,255,255,255,255,255,255,255,255,255,255,255,255,255,255,255,255,255,255,255,255,255,255,255,255,16,17,18,19,20,21,255,255,255,255,255,255,255,255,255,255,255,255,255,255,255,255,255,255,255,255,255,255,255,255,255,255,255,255,255,255,255,255,255,255,255,255,255,255,255,255,255,255,255,255,255,255,255,255,255,255,255,255,255,255,255,255,255,255,255,255,255,255,255,255,255,255,255,255,255,255,255,255,255,255,255,255,255,255,255,255,255,255,255,255,255,255,255,255,255,255,255,255,255,255,255,255,255,255,255,255,48,49,50,51,52,53,255,255,255,255,255,255,255,255,255,255,255,255,255,255,255,255,16,17,18,19,20,21,255,255,255,255,255,255,255,255,255,255,255,255,255,255,48,49,50,51,50,51,50,51,50,51,52,53,255,255,255,255,255,255,255,255,255,255,255,255,255,255,255,255,255,255,48,49,52,53,255,255,255,255,255,255,255,255,255,255,255,255,255,255,255,255,255,255,255,255,255,255,255,255,255,255,255,255,255,255,255,255,255,255,255,255,255,255,255,255,31,31,31,31,31,31,31,31,31,31,31,31,31,31,31,31
66,67,66,67,66,67,66,67,68,69,255,255,255,255,255,255,255,255,255,255,255,255,255,255,255,255,255,255,255,255,255,255,255,255,255,255,255,255,255,255,255,255,255,255,255,255,255,255,32,33,34,35,36,37,255,255,255,255,255,255,255,255,255,255,255,255,255,255,255,255,255,255,255,255,255,255,255,255,255,255,255,255,255,255,255,255,255,255,255,255,255,255,255,255,255,255,255,255,255,255,255,255,255,255,255,255,255,255,255,255,255,255,255,255,255,255,255,255,255,255,255,255,255,255,255,255,255,255,255,255,255,255,255,255,255,255,255,255,255,255,255,255,255,255,255,255,255,255,255,255,255,255,255,255,64,65,66,67,68,69,255,255,255,255,255,255,255,255,255,255,255,255,255,255,255,255,32,33,34,35,36,37,255,255,255,255,255,255,255,255,255,255,255,255,255,255,64,65,66,67,66,67,66,67,66,67,68,69,255,255,255,255,255,255,255,255,255,255,255,255,255,255,255,255,255,255,64,65,68,69,255,255,255,255,255,255,255,255,255,255,255,255,255,255,255,255,255,255,255,255,255,255,255,255,255,255,255,255,255,255,255,255,255,255,255,255,255,255,255,255,31,31,31,31,31,31,31,31,31,31,31,31,31,31,31,31
50,51,50,51,50,51,50,51,52,53,255,255,255,255,255,255,255,255,255,255,255,255,255,255,255,255,255,255,255,255,255,255,255,255,255,255,255,255,255,255,255,255,255,255,255,255,255,255,48,49,50,51,52,53,255,255,255,255,255,255,255,255,255,255,255,255,255,255,255,255,255,255,255,255,255,255,255,255,255,255,255,255,255,255,255,255,255,255,255,255,255,255,255,255,255,255,255,255,255,255,255,255,255,255,255,255,255,255,255,255,255,255,255,255,255,255,255,255,255,255,255,255,255,255,255,255,255,255,255,255,255,255,255,255,255,255,255,255,255,255,255,255,255,255,255,255,255,255,255,255,255,255,255,255,48,49,50,51,52,53,12,255,255,255,255,255,255,255,255,255,255,255,255,255,255,255,48,49,50,51,50,51,18,19,18,19,20,21,255,255,255,255,255,255,255,255,48,49,50,51,50,51,50,51,50,51,52,53,255,255,255,255,255,255,255,255,255,255,255,255,255,255,255,255,255,255,48,49,52,53,255,255,255,255,255,255,255,255,255,255,255,255,255,255,255,255,255,255,255,255,255,255,255,255,255,255,255,255,255,255,255,255,255,255,255,255,255,255,255,255,31,31,31,31,31,31,31,31,31,31,31,31,31,31,31,31
66,67,66,67,66,67,66,67,68,69,255,255,255,255,255,255,255,255,255,255,255,255,255,255,255,255,255,255,255,255,255,255,255,255,255,255,255,255,255,255,255,255,255,255,255,255,255,255,64,65,66,67,68,69,255,255,255,255,255,255,255,255,255,255,255,255,255,255,255,255,255,255,255,255,255,255,255,255,255,255,255,255,255,255,255,255,255,255,255,255,255,255,255,255,255,255,255,255,255,255,255,255,255,255,255,255,255,255,255,255,255,255,255,255,255,255,255,255,255,255,255,255,255,255,255,255,255,255,255,255,255,255,255,255,255,255,255,255,255,255,255,255,255,255,255,255,255,255,255,255,255,255,255,255,64,65,66,67,68,69,255,255,255,255,255,255,255,255,255,255,255,255,255,255,255,255,64,65,66,67,66,67,34,35,34,35,36,37,255,255,255,255,255,255,255,255,64,65,66,67,66,67,66,67,66,67,68,69,255,255,255,255,255,255,255,255,255,255,255,255,255,255,255,255,255,255,64,65,68,69,255,255,255,255,255,255,255,255,255,255,255,12,255,255,255,255,255,12,255,255,255,255,255,255,255,255,255,255,255,255,255,255,255,255,255,255,255,255,255,255,31,31,31,31,31,31,31,31,31,31,31,31,31,31,31,31
50,51,50,51,50,51,50,51,52,53,255,255,255,255,255,255,255,255,255,255,255,255,255,255,255,255,255,255,255,255,255,255,255,255,255,255,16,17,18,19,20,21,255,255,255,255,255,255,48,49,50,51,52,53,255,255,255,255,255,255,255,255,255,255,255,255,255,255,255,255,255,255,255,255,255,255,255,255,255,255,255,255,255,255,255,255,255,255,255,255,255,255,255,255,255,255,255,255,255,255,255,255,255,255,255,255,255,255,255,255,255,255,255,255,255,255,255,255,255,255,255,11,255,255,255,255,255,255,255,255,255,255,255,255,255,255,255,255,255,255,255,255,255,255,255,255,255,255,255,255,255,255,255,255,48,49,50,51,50,51,18,19,18,19,20,21,255,255,255,255,255,255,255,255,255,255,48,49,50,51,52,53,255,255,255,255,255,255,255,255,255,255,255,255,255,255,48,49,50,51,50,51,50,51,50,51,52,53,255,255,255,255,255,255,255,255,255,255,255,255,255,255,255,255,255,255,48,49,52,53,255,255,255,255,255,255,255,255,16,17,255,255,18,19,18,19,255,255,20,21,255,255,255,255,255,255,255,255,255,255,255,255,255,255,255,255,255,255,255,255,31,31,31,31,31,31,31,31,31,31,31,31,31,31,31,31
66,67,66,67,66,67,66,67,68,69,255,255,255,255,255,255,255,255,255,255,255,255,255,255,255,255,255,255,255,255,255,255,255,255,255,255,32,33,34,35,36,37,255,255,255,255,255,255,64,65,66,67,68,69,255,255,255,255,255,255,255,255,255,255,255,255,255,255,255,255,255,255,255,255,255,255,255,255,255,255,255,255,255,255,255,255,255,255,255,255,255,255,255,255,255,255,255,255,255,255,255,255,255,255,255,255,255,255,255,255,255,255,255,255,255,255,255,255,255,255,255,255,255,255,255,255,255,255,255,255,255,255,255,255,255,255,255,255,255,255,255,255,255,255,255,255,255,255,255,255,255,255,255,255,64,65,66,67,66,67,34,35,34,35,36,37,255,255,255,255,255,255,255,255,255,255,64,65,66,67,68,69,255,255,255,255,255,255,255,255,255,255,255,255,255,255,64,65,66,67,66,67,66,67,66,67,68,69,255,255,255,255,255,255,255,255,255,255,255,255,255,255,255,255,255,255,64,65,68,69,255,255,255,255,255,255,255,255,32,33,255,1,34,35,34,35,255,1,36,37,255,255,255,255,255,255,255,255,255,255,255,255,255,255,255,255,255,255,255,255,31,31,31,31,31,31,31,31,31,31,31,31,31,31,31,31
50,51,50,51,50,51,50,51,52,53,255,255,255,255,255,255,255,255,255,255,255,255,255,255,255,255,255,255,255,255,255,255,255,255,255,255,48,49,50,51,52,53,255,255,255,255,255,255,48,49,50,51,52,53,255,255,255,255,255,255,255,255,255,255,255,255,255,255,255,255,255,255,255,255,255,255,255,255,255,255,255,255,255,255,255,255,255,255,255,255,255,255,255,255,255,255,255,255,255,255,255,255,255,255,255,255,255,255,255,255,255,255,255,16,17,18,19,18,19,18,19,20,21,255,255,255,255,255,255,255,255,255,255,255,255,255,255,255,255,255,255,255,255,255,255,255,255,255,255,255,255,255,255,255,255,255,255,255,255,255,255,255,255,255,255,255,255,255,255,255,255,255,255,255,255,255,48,49,50,51,52,53,255,255,255,255,255,255,255,255,255,255,255,255,255,255,48,49,50,51,50,51,50,51,50,51,52,53,255,255,255,255,255,255,255,255,255,255,255,255,255,255,255,255,255,255,48,49,52,53,255,255,255,255,255,255,255,255,255,255,255,255,255,255,255,255,255,255,52,53,255,255,255,255,255,255,255,255,255,255,255,255,255,255,255,255,255,255,255,255,31,31,31,31,31,31,31,31,31,31,31,31,31,31,31,31
66,67,66,67,66,67,66,67,68,69,255,255,255,255,255,255,255,255,255,255,255,255,255,255,255,255,255,255,255,255,255,255,255,255,255,255,64,65,66,67,68,69,255,255,255,255,255,255,64,65,66,67,68,69,255,255,255,255,255,255,255,255,255,255,255,255,255,255,255,255,255,255,255,255,255,255,255,255,255,255,255,255,255,255,255,255,255,255,255,255,255,255,255,255,255,255,255,255,255,255,255,255,255,255,255,255,255,255,255,255,255,255,255,32,33,34,35,34,35,34,35,36,37,255,255,255,255,255,255,255,255,255,255,255,255,255,255,255,255,255,255,255,255,255,255,255,255,255,255,255,255,255,255,255,255,1,255,255,255,255,255,255,255,255,255,255,255,255,255,255,255,255,255,255,255,255,64,65,66,67,68,69,255,255,255,255,255,255,255,255,255,255,255,255,255,255,64,65,66,67,66,67,66,67,66,67,68,69,255,255,255,255,13,255,255,255,255,255,255,255,255,255,255,255,13,255,64,65,68,69,255,255,255,255,255,255,255,255,255,255,255,255,255,255,255,255,255,255,68,69,255,255,255,255,255,255,255,255,255,255,255,255,255,255,255,255,255,255,255,255,31,31,31,31,31,31,31,31,31,31,31,31,31,31,31,31
50,51,50,51,50,51,50,51,52,53,255,10,255,255,255,255,255,255,255,255,255,255,255,255,255,255,16,17,18,19,20,21,255,255,255,255,48,49,50,51,52,53,255,255,255,255,255,255,48,49,50,51,52,53,255,255,255,255,255,255,255,255,255,255,255,255,255,16,17,18,19,20,21,255,255,255,255,255,255,255,255,255,255,255,255,255,255,255,255,255,255,255,255,255,255,255,255,255,255,255,255,255,255,255,255,255,255,255,255,11,255,16,17,50,51,50,51,50,51,50,51,50,51,20,21,255,255,255,255,255,255,255,255,255,255,255,255,255,255,255,255,255,255,255,255,255,255,255,255,255,255,255,255,255,255,255,255,255,255,255,255,255,255,255,255,255,255,255,255,255,255,255,255,255,12,255,48,49,50,51,52,53,255,13,255,255,255,255,16,17,18,19,18,19,18,19,50,51,50,51,50,51,50,51,50,51,52,53,255,255,255,255,255,255,255,255,255,255,255,255,255,255,255,255,255,255,48,49,50,51,18,19,20,21,255,255,255,255,255,255,255,255,255,255,255,255,255,255,52,53,255,255,255,255,255,255,255,255,255,255,255,255,255,255,255,255,255,255,255,255,31,31,31,31,31,31,31,31,31,31,31,31,31,31,31,31
66,67,66,67,66,67,66,67,68,69,255,255,255,255,255,255,255,255,255,255,255,255,255,255,255,255,32,33,34,35,36,37,255,255,255,255,64,65,66,67,68,69,255,255,255,255,255,255,64,65,66,67,68,69,255,255,255,255,255,255,255,255,255,255,255,255,255,32,33,34,35,36,37,255,255,255,255,255,255,255,255,255,255,255,255,255,255,255,255,255,255,255,255,255,255,255,255,255,255,255,255,255,255,255,255,255,255,255,255,255,255,32,33,66,67,66,67,66,67,66,67,66,67,36,37,255,255,255,255,255,255,255,255,255,255,255,255,255,255,255,255,12,255,255,255,255,255,12,255,255,255,255,255,255,255,1,255,255,255,255,255,255,255,255,255,255,255,255,255,255,255,255,255,255,255,255,64,65,66,67,68,69,255,255,255,255,255,255,32,33,34,35,34,35,34,35,66,67,66,67,66,67,66,67,66,67,68,69,255,255,255,255,255,255,255,255,255,255,255,255,255,255,255,255,255,255,64,65,66,67,34,35,36,37,255,255,255,255,255,255,255,255,255,255,255,255,255,255,68,69,255,255,255,255,255,255,255,255,255,255,255,255,255,255,255,0,255,255,255,255,31,31,31,31,31,31,31,31,31,31,31,31,31,31,31,31
18,19,18,19,18,19,18,19,18,19,18,19,18,19,18,19,18,19,18,19,18,19,18,19,18,19,18,19,18,19,18,19,18,19,18,19,18,19,18,19,18,19,18,19,18,19,18,19,50,51,50,51,52,53,255,255,255,255,255,255,255,255,255,255,255,255,255,255,255,255,255,255,255,255,255,255,255,255,255,255,255,255,255,255,255,255,255,255,255,255,255,255,255,255,255,255,255,255,255,255,255,255,255,255,255,255,255,255,255,16,17,50,51,50,51,50,51,50,51,50,51,50,51,50,51,20,21,255,255,255,255,255,255,255,255,255,255,255,255,255,18,19,255,255,255,255,18,19,255,255,255,255,255,255,255,255,255,255,255,255,255,255,255,255,255,255,255,255,255,255,16,17,18,19,18,19,50,51,50,51,52,53,255,255,255,255,255,255,255,255,255,255,255,255,255,255,255,255,255,255,255,255,255,255,255,255,255,255,255,255,255,255,255,255,255,255,255,255,255,255,255,255,255,255,255,255,255,255,255,255,255,255,255,255,255,255,255,255,255,255,255,255,255,255,255,255,255,255,52,53,255,255,255,255,255,255,255,255,255,255,255,255,255,255,255,255,255,255,255,255,31,31,31,31,31,31,31,31,31,31,31,31,31,31,31,31
34,35,34,35,34,35,34,35,34,35,34,35,34,35,34,35,34,35,34,35,34,35,34,35,34,35,34,35,34,35,34,35,34,35,34,35,34,35,34,35,34,35,34,35,34,35,34,35,66,67,66,67,68,69,255,255,255,255,255,255,255,255,255,255,255,255,255,255,255,255,255,255,255,255,255,255,255,255,255,255,255,255,255,255,255,255,255,255,255,255,255,255,255,1,255,1,255,255,255,255,255,255,255,255,255,255,255,255,255,32,33,66,67,66,67,66,67,66,67,66,67,66,67,66,67,36,37,255,255,255,255,255,255,255,255,255,255,255,255,255,34,35,255,255,255,255,34,35,255,255,255,255,255,255,255,1,255,255,255,255,255,255,255,255,255,255,255,255,255,255,32,33,34,35,34,35,66,67,66,67,68,69,255,1,255,255,255,255,255,255,255,255,255,255,255,255,255,255,255,255,255,255,255,255,255,255,255,255,255,255,255,255,255,255,255,255,255,255,255,255,255,255,255,255,255,255,255,255,255,255,255,255,255,255,255,255,255,255,255,255,255,255,255,255,255,255,255,255,68,69,255,255,255,255,255,255,255,255,255,255,255,255,255,255,255,255,255,255,255,255,31,31,31,31,31,31,31,31,31,31,31,31,31,31,31,31
50,51,50,51,50,51,50,51,50,51,50,51,50,51,50,51,50,51,50,51,50,51,50,51,50,51,50,51,50,51,50,51,50,51,50,51,50,51,50,51,50,51,50,51,50,51,50,51,50,51,50,51,52,53,255,255,255,255,255,255,255,255,255,255,255,255,255,255,255,255,255,255,255,255,255,255,255,255,255,255,255,255,255,255,255,255,11,255,255,255,255,255,255,255,255,255,255,255,255,255,255,255,255,255,255,255,255,16,17,50,51,50,51,50,51,50,51,50,51,50,51,50,51,50,51,50,51,20,21,255,255,255,255,255,255,255,255,255,255,255,50,51,255,255,255,255,50,51,255,255,255,255,255,255,255,255,255,255,255,255,255,255,255,255,11,255,255,255,255,255,255,255,255,255,255,255,48,49,50,51,52,53,255,255,255,255,255,255,255,255,255,255,255,255,255,255,255,255,255,255,255,255,255,255,255,255,255,255,255,255,255,255,255,255,255,255,255,255,255,255,255,255,255,255,255,255,255,255,255,255,255,255,255,255,255,255,255,255,255,255,255,255,255,255,255,255,255,255,52,53,255,255,255,255,255,255,255,255,255,255,255,255,255,255,255,255,255,255,255,255,31,31,31,31,31,31,31,31,31,31,31,31,31,31,31,31
66,67,66,67,66,67,66,67,66,67,66,67,66,67,66,67,66,67,66,67,66,67,66,67,66,67,66,67,66,67,66,67,66,67,66,67,66,67,66,67,66,67,66,67,66,67,66,67,66,67,66,67,68,69,255,255,255,255,255,255,255,255,255,255,255,255,255,255,255,255,255,255,255,255,255,255,255,255,255,255,255,255,255,255,255,255,255,255,255,255,255,255,255,1,255,1,255,255,255,255,255,255,255,255,255,255,255,32,33,66,67,66,67,66,67,66,67,66,67,66,67,66,67,66,67,66,67,36,37,255,255,255,255,255,255,255,255,255,255,255,66,67,255,255,255,255,66,67,255,255,255,255,255,255,255,1,255,255,255,255,255,255,255,255,255,255,255,255,255,255,255,255,255,255,255,255,64,65,66,67,68,69,255,1,255,1,255,255,255,255,255,255,255,255,255,255,255,255,255,255,255,255,255,255,255,255,255,255,255,255,255,255,255,255,255,255,255,255,255,255,255,255,255,255,255,255,255,255,255,255,255,255,255,255,255,255,255,255,255,255,255,255,255,255,255,255,255,255,68,69,255,255,255,255,255,255,255,255,255,255,255,255,255,255,255,255,255,255,255,255,31,31,31,31,31,31,31,31,31,31,31,31,31,31,31,31
50,51,50,51,50,51,50,51,50,51,50,51,50,51,50,51,50,51,50,51,50,51,50,51,50,51,50,51,50,51,50,51,50,51,50,51,50,51,50,51,50,51,50,51,50,51,50,51,50,51,50,51,52,53,47,47,47,47,47,47,16,17,18,19,18,19,18,19,18,19,18,19,18,19,18,19,18,19,18,19,18,19,18,19,18,19,18,19,18,19,18,19,18,19,18,19,18,19,18,19,18,19,18,19,18,19,18,19,18,19,18,19,18,19,18,19,18,19,18,19,18,19,18,19,18,19,18,19,18,19,18,19,18,19,18,19,18,19,18,19,50,51,18,19,18,19,50,51,18,19,18,19,18,19,18,19,18,19,18,19,18,19,18,19,18,19,18,19,18,19,18,19,18,19,18,19,18,19,18,19,18,19,18,19,18,19,18,19,18,19,18,19,18,19,18,19,18,19,18,19,18,19,18,19,18,19,18,19,20,21,255,255,255,255,255,255,255,255,255,255,255,255,255,255,16,17,18,19,18,19,18,19,18,19,18,19,18,19,18,19,47,47,18,19,18,19,47,47,18,19,18,19,18,19,18,19,18,19,18,19,18,19,18,19,18,19,18,19,18,19,18,19,18,19,18,19,18,19,18,19,18,19,18,19,18,19
66,67,66,67,66,67,66,67,66,67,66,67,66,67,66,67,66,67,66,67,66,67,66,67,66,67,66,67,66,67,66,67,66,67,66,67,66,67,66,67,66,67,66,67,66,67,66,67,66,67,66,67,68,69,47,47,47,47,47,47,32,33,34,35,34,35,34,35,34,35,34,35,34,35,34,35,34,35,34,35,34,35,34,35,34,35,34,35,34,35,34,35,34,35,34,35,34,35,34,35,34,35,34,35,34,35,34,35,34,35,34,35,34,35,34,35,34,35,34,35,34,35,34,35,34,35,34,35,34,35,34,35,34,35,34,35,34,35,34,35,66,67,34,35,34,35,66,67,34,35,34,35,34,35,34,35,34,35,34,35,34,35,34,35,34,35,34,35,34,35,34,35,34,35,34,35,34,35,34,35,34,35,34,35,34,35,34,35,34,35,34,35,34,35,34,35,34,35,34,35,34,35,34,35,34,35,34,35,36,37,255,1,255,1,255,1,255,1,255,1,255,1,255,1,32,33,34,35,34,35,34,35,34,35,34,35,34,35,34,35,47,47,34,35,34,35,47,47,34,35,34,35,34,35,34,35,34,35,34,35,34,35,34,35,34,35,34,35,34,35,34,35,34,35,34,35,34,35,34,35,34,35,34,35,34,35
50,51,50,51,50,51,50,51,50,51,50,51,50,51,50,51,50,51,50,51,50,51,50,51,50,51,50,51,50,51,50,51,50,51,50,51,50,51,50,51,50,51,50,51,50,51,50,51,50,51,50,51,52,53,47,47,47,47,47,47,48,49,50,51,50,51,50,51,50,51,50,51,50,51,50,51,50,51,50,51,50,51,50,51,50,51,50,51,50,51,50,51,50,51,50,51,50,51,50,51,50,51,50,51,50,51,50,51,50,51,50,51,50,51,50,51,50,51,50,51,50,51,50,51,50,51,50,51,50,51,50,51,50,51,50,51,50,51,50,51,50,51,50,51,50,51,50,51,50,51,50,51,50,51,50,51,50,51,50,51,50,51,50,51,50,51,50,51,50,51,50,51,50,51,50,51,50,51,50,51,50,51,50,51,50,51,50,51,50,51,50,51,50,51,50,51,50,51,50,51,50,51,50,51,50,51,50,51,52,53,47,47,47,47,47,47,47,47,47,47,47,47,47,47,48,49,50,51,50,51,50,51,50,51,50,51,50,51,50,51,47,47,50,51,50,51,47,47,50,51,50,51,50,51,50,51,50,51,50,51,50,51,50,51,50,51,50,51,50,51,50,51,50,51,50,51,50,51,50,51,50,51,50,51,50,51
66,67,66,67,66,67,66,67,66,67,66,67,66,67,66,67,66,67,66,67,66,67,66,67,66,67,66,67,66,67,66,67,66,67,66,67,66,67,66,67,66,67,66,67,66,67,66,67,66,67,66,67,68,69,47,47,47,47,47,47,64,65,66,67,66,67,66,67,66,67,66,67,66,67,66,67,66,67,66,67,66,67,66,67,66,67,66,67,66,67,66,67,66,67,66,67,66,67,66,67,66,67,66,67,66,67,66,67,66,67,66,67,66,67,66,67,66,67,66,67,66,67,66,67,66,67,66,67,66,67,66,67,66,67,66,67,66,67,66,67,66,67,66,67,66,67,66,67,66,67,66,67,66,67,66,67,66,67,66,67,66,67,66,67,66,67,66,67,66,67,66,67,66,67,66,67,66,67,66,67,66,67,66,67,66,67,66,67,66,67,66,67,66,67,66,67,66,67,66,67,66,67,66,67,66,67,66,67,68,69,47,47,47,47,47,47,47,47,47,47,47,47,47,47,64,65,66,67,66,67,66,67,66,67,66,67,66,67,66,67,47,47,66,67,66,67,47,47,66,67,66,67,66,67,66,67,66,67,66,67,66,67,66,67,66,67,66,67,66,67,66,67,66,67,66,67,66,67,66,67,66,67,66,67,66,67
